       C 70, 20, 150
           

NO      ./textures/konoha.xpm        
SO ./textures/cloud.xpm

EA  ./textures/eye.xpm    
WE      ./textures/shuriken.xpm     

F       20,     20, 20



1111111111111111111111111111111111
1E00000000000000000000000000000001
1000000000000000000000000000000001
1000000000000000000000000000000001
1000000000000000000000000000000001
1000000000000000000000000000000001
1000000000000000000000000000000001
1000000000000000000000000000000001
100000000000000000000000000000000111111111111
111111111111111110000000000000000000000000001
                10000000000000000000000000001
                10000000000000000000000000001
                10000000000000000000000000001
                10000000000000000000000000001
                10000000000000000000000000001
                10000000000000000000000000001
                10000000000000000000000000001
                10000000000000000000000000001
111111111111111110000000000000000000000000001
100000000000000000000000000000010111111111111
100000000000000000000000000000001
100000000000000000000000000000001
100000000000000000000000000000001
100000000000000000000000000000001
100000000000000000000000000000001
100000000000000000000000000000001
100000000000000000000000000000001
111111111111111111111111111111111
